NO ./textures/mc_grass_block_side.png
SO ./textures/mc_bricks_64.png
WE ./textures/mc_oak_log_64.png
EA ./textures/mc_cobblestone_64.png
F 220,100,0
C 225,30,0
F 100,100,100

111111
100101
101001
1100N1
111111
