NO ./textures/mc_grass_block_side.png
SO ./textures/mc_bricks_64.png
WE ./textures/mc_oak_log_64.png
EA ./textures/mc_cobblestone_64.png

F 113,177,71
C 142,190,255

111111111
100000001
W00000001
100000001
111111111
