NO ./textures/custom/br_wall_alt.png
SO ./textures/custom/br_wall_alt.png
WE ./textures/custom/br_wall_alt.png
EA ./textures/custom/br_wall_alt.png

F 96,86,44
C 136,114,47

11111111111111111111111111
10000100000010001000001101
10110101111010101011101101
10010101000010101010000001
11010101011010101010111101
10010001010000001010100001
10111111010111111010101111
10000000010100100010101001
11111111010100101110101001
10000N01000000001000001101
10111101111011101011111101
10000000000010001000000001
11111111111111111111111111
