NO ./textures/mc_grass_block_side.png
SO ./textures/mc_bricks_64.png
WE ./textures/mc_oak_log_64.png
EA ./textures/mc_cobblestone_64.png

F 113,177,71
C 142,190,255

111111111
101000001
101000001
101001001
100000001
100000N01
111111111
