NO ./textures/custom/bk_blood.png
SO ./textures/custom/bk_blood.png
WE ./textures/custom/bk_blood.png
EA ./textures/custom/bk_blood.png

F 70,0,0
C 0,0,0

111111111111111111111
100000100000001000001
101110101111101011101
100000000000000000001
111111101111101111111
100000000000000000001
100011101100001001001
1000111011000N1011001
100011101100001001001
100000000000000000001
111111111111111111111
