NO ./textures/custom/doom_metal.png
SO ./textures/custom/doom_moss.png
WE ./textures/custom/doom_metal.png
EA ./textures/custom/doom_moss.png

F 50,200,50
C 100,20,20

11111111111111111111
10000010000000000001
10000010000000N00001
11110011111000000001
10000000001000000001
10001000001000000001
10011100001111111111
10001000000000111111
10000000000000100001
11111111111111111111
