NO ./textures/custom/br_wall.png
SO ./textures/custom/br_wall.png
WE ./textures/custom/br_wall.png
EA ./textures/custom/br_wall.png

F 10,10,10
C 30,30,45

1111111111111111111111111111111111
1100111111111110011111111111111111
11000000000000000000000000000000N1
1100111111111110011111111111111111
1111111111111111111111111111111111
