NO ./textures/custom/wolf_grey.png
SO ./textures/custom/wolf_grey.png
WE ./textures/custom/wolf_grey.png
EA ./textures/custom/wolf_grey.png

F 100,50,50
C 50,50,150

111111111111111111111111111
100000100000001000010000001
101110101111101011010111101
100010001000000001000100101
111011111011111111111101101
100000000010000000000000101
101111111110111111111111101
100000000000N00000000000001
111111111111111111111111111
