NO ./textures/custom/pac_wall.png
SO ./textures/custom/pac_wall.png
WE ./textures/custom/pac_wall.png
EA ./textures/custom/pac_wall.png

F 0,0,0
C 0,0,0

1111111111111111111111111111
1000000000000110000000000001
1011110111110110111110111101
1011110111110110111110111101
1000000000000000000000000001
1011110110111111111101101111
1000000110000011000001100001
1111110111111011011111101111
0000010110000000000001101000
1111110110111100111101101111
10000000001000N0000100000001
1111110110111111111101101111
0000010110000000000001101000
1111110110111111111101101111
1000000000000110000000000001
1011110111110110111110111101
1000110000000000000001100001
1110110110111111111101101111
1000000110000011000001100001
1011111111111011011111111101
1000000000000000000000000001
1111111111111111111111111111
