NO ./textures/custom/wolf_grey.png
SO ./textures/custom/wolf_blue.png
WE ./textures/custom/wolf_wood.png
EA ./textures/custom/wolf_red.png

F 113,113,113
C 56,56,56

111111111111111111
100000000000000001
100110000001111101
100100000001000101
1001000N0001000101
100100000001000101
100111000001111101
100000000000000001
111111100111111111
100000000000000001
100000000000000001
111111111111111111
